111111111
111110231
110023001
113010001
102011111
140011111
111111111
111111111