111111111
100411301
101011301
100211001
100000011
100002011
100111111
111111111