11111111111
10001000001
10032011001
10132113301
10110002211
10010001001
11220001101
10331123101
10011023001
10004010001
11111111111
