111111111111
111111111111
111111000111
100003032011
102040000011
111021111111
111001111111
111001111111
111000031111
111111111111
111111111111
111111111111